Linux is an open-source operating system. It is like Windows, Mac, Android, etc.

Unix is also an operating system like Linux. It is an commercial OS. It consists of three parts: Kernal, Shell and Programs. Most of the Unix and Linux commands are similar in nature.

Linux kernel is a low-level system software.It provides an interface for user-level interaction.
It manages the system resources such as RAM,Disk,Processor, output devices etc.



Basic commands

Name - create a folder
purpose - creation of folder
itsacheckmate@itscheckmate:~$ mkdir linuxfolder
itsacheckmate@itscheckmate:~$ ls
Desktop    Downloads    Music     Public  temp   temp2      temporary  Training
Documents  linuxfolder  Pictures  snap    temp1  Templates  temp.txt   Videos

mkdir -v - displays message for every directory created
itsacheckmate@itscheckmate:~$ mkdir -v linuxtemp
mkdir: created directory 'linuxtemp'

-p flag => enables commands to create parent directory as necessary
itsacheckmate@itscheckmate:~$ mkdir -v -p a/b/c
mkdir: created directory 'a'
mkdir: created directory 'a/b'
mkdir: created directory 'a/b/c'

-m option => It is used to set the file mode/permission of the folder created
itsacheckmate@itscheckmate:~$ mkdir -m a=rx abc
itsacheckmate@itscheckmate:~$ mkdir -v -m o=r abcd
mkdir: created directory 'abcd'

-----------------------------------------------------------

Name - Change Directory
purpose navigate the directory in the linux terminal
itsacheckmate@itscheckmate:~$ cd Desktop

cd ~ => used to change the directory to home directory
tsacheckmate@itscheckmate:~/Desktop$ cd ~
itsacheckmate@itscheckmate:~$ 
cd .. => goes one directory back
d "dir name" or cd dir\ name => this used to navigate to the directory with the white spaces

-------------------------------------------------------------


Name -       Delete Folder
Purpose-  Deletes the folder  
Examples- rmdir is used to remove the emplty folder  
-p =>option each of the directory argument is treated as a pathname of which all
 components will be removed, if they are already empty, starting from the last component
-v/-verbose => this option will show the verbose info
–ignore-fail-on-non-empty => this option will not report failure if the direcotry is not empty

itsacheckmate@itscheckmate:~$ rmdir linuxfolder

itsacheckmate@itscheckmate:~$ rmdir ab
itsacheckmate@itscheckmate:~$ rmdir ab
rmdir: failed to remove 'ab': No such file or directory
itsacheckmate@itscheckmate:~$ rmdir -v a
rmdir: removing directory, 'a'
rmdir: failed to remove 'a': Directory not empty(only remove empty)

--------------------------------------------------------

rm - it is the remove command which deletes the objects such as files,directories , symbolic links etc.And, if the command has been executed it cant be undone.
itsacheckmate@itscheckmate:~$ rm temp.txt

rm -i=> this asks before deleting the file
itsacheckmate@itscheckmate:~$ rm -i temp1
rm: remove regular empty file 'temp1'?
rm -f a.txt => if the file is write protected it foces to delete it but wont work in the write protected directories
-r (recursive option) - it will perform a tree-walk and will delete all the files and sub-directories recursively normally rm donot delete directory but using this option it will delete the directory.

--------------------------------------
Rename Folder
Purpose-   Rename the named files according to regular expression perlexpr, can change name of multiple files
rename -s => it is going to ingnore the symbolic links
rename -v => verbose will show the files which is being renamed
rename -n=>if the user want  to see only final change
rename -o =>will not overwrite existing files
rename -V => shows the version
rename -help=> help message and exit

rename [options] expression replacement file...

itsacheckmate@itsacheckmate:~/Training/Linux/practice$ rename -v 's/a1/b' a.txt
Substitution replacement not terminated at (user-supplied code).
itsacheckmate@itsacheckmate:~/Training/Linux/practice$ rename -v 's/a1/b/' a.txt
itsacheckmate@itsacheckmate:~/Training/Linux/practice$ ls
a1.txt  aa1.txt  aa.txt  a.txt
itsacheckmate@itsacheckmate:~/Training/Linux/practice$ rename -v 's/a1/b/' a1.txt
a1.txt renamed as b.txt
itsacheckmate@itsacheckmate:~/Training/Linux/practice$ rename -n 's/a*/b/' a1.txt
rename(a1.txt, b1.txt)
itsacheckmate@itsacheckmate:~/Training/Linux/practice$ rename -n 's/a*/b/' *.txt
rename(aa1.txt, b1.txt)
aa.txt not renamed: b.txt already exists
a.txt not renamed: b.txt already exists
rename(b.txt, bb.txt)
itsacheckmate@itsacheckmate:~/Training/Linux/practice$ ls
aa1.txt  aa.txt  a.txt  b.txt

-----------------------------------------------
Moving
mv stands for move. mv is used to move one or more files or directories from one place to another in a file system like UNIX. It has two distinct functions: 
(i) It renames a file or folder. 
(ii) It moves a group of files to a different directory. 

mv [Option] source destination
options 
-i =interactive it just ask for user confirmation 
-f = force moves the write protected files or the write protected destination file
-n = no clobber  prevents the overwriting of the existing files
-b = backup creates the backup of the existing file that is going to be overwritten

itsacheckmate@itscheckmate:~$ mv a geek.txt

itsacheckmate@itscheckmate:~$ mv -n abc geek.txt
mv: cannot move 'abc' to 'geek.txt/abc': Permission denied

itsacheckmate@itsacheckmate:~ mv -b b.txt geek.txt
itsacheckmate@itsacheckmate:~ls
aa1.txt  aa.txt  geek.txt  geek.txt~
itsacheckmate@itsacheckmate:~ mv -i aa.txt geek.txt
mv: overwrite 'geek.txt'? n
itsacheckmate@itsacheckmate:~ ls
aa1.txt  aa.txt  geek.txt  geek.txt~

------------------------------------------

Copy
cp stands for copy. This command is used to copy files or group of files or directory. It creates an exact image of a file on a disk with different file name. cp command require at least two filenames in its arguments.
-r = recursive copying used to copy directory and all the files in it to other directory
-i = interactive with this option it asks the user confirmation
-b = backup creates the destination file backup in the same folder but different name and formats
-f = force used to copy write protected destination files 
-p = preserve it preserves the chracteristics of the souce file int destination like last modification date and time
itsacheckmate@itscheckmate:~/Practise$ touch a.txt
itsacheckmate@itscheckmate:~/Practise$ cp a.txt b.txt
itsacheckmate@itscheckmate:~/Practise$ ls
a.txt  b.txt

itsacheckmate@itscheckmate:~/Practise$ cp -i a.txt b.txt
cp: overwrite 'b.txt'? y
itsacheckmate@itscheckmate:~/Practise$ cat b.txt
HI
itsacheckmate@itscheckmate:~/Practise$ cp -b a.txt b.txt
itsacheckmate@itscheckmate:~/Practise$ ls
a.txt  b.txt  b.txt~
$ ls -l b.txt
-r-xr-xr-x+ 1 User User 3 Nov 24 08:45 b.txt

User, group and others doesn't have writing permission.

Without -f option, command not executed
$ cp a.txt b.txt
cp: cannot create regular file 'b.txt': Permission denied

With -f option, command executed successfully
$ cp -f a.txt b.txt
root@itscheckmate:/home/itsacheckmate/Practise# ls -l a.txt
-rw-rw-r-- 1 itsacheckmate itsacheckmate 3 Apr 20 13:58 a.txt
root@itscheckmate:/home/itsacheckmate/Practise# cp -p a.txt c.txt
root@itscheckmate:/home/itsacheckmate/Practise# ls -l c.txt
-rw-rw-r-- 1 itsacheckmate itsacheckmate 3 Apr 20 13:58 c.txt


-----------------------------------------

#System Information
uname -a (Display Linux system information)
Linux itscheckmate 5.13.0-39-generic #44~20.04.1-Ubuntu SMP Thu Mar 24 16:43:35 UTC 2022 x86_64 x86_64 x86_64 GNU/Linux

uname -r (Display kernel release information)
5.13.0-39-generic

uptime (Shows how long the system is running + load uptime)
 14:11:49 up  1:32,  1 user,  load average: 0.49, 0.41, 0.45

hostname (Shows system host name)
itscheckmate

hostname -I (Display all local IP addresses of the host)
192.168.11.104 

last reboot (Shows system reboot system)
reboot   system boot  5.13.0-39-generi Tue Apr 19 12:39   still running
reboot   system boot  5.11.0-27-generi Tue Apr 19 22:24 - 12:39  (-9:44)
reboot   system boot  5.11.0-27-generi Fri Apr 15 00:15 - 00:16  (00:01)
reboot   system boot  5.11.0-27-generi Thu Apr 14 23:18 - 23:24  (00:05)

wtmp begins Thu Apr 14 23:18:30 2022

date (shows the current date and time)
Tuesday 19 April 2022 02:16:42 PM IST

 cal (Shows this months calendar)
     April 2022       
Su Mo Tu We Th Fr Sa  
                1  2  
 3  4  5  6  7  8  9  
10 11 12 13 14 15 16  
17 18 19 20 21 22 23  
24 25 26 27 28 29 30  

w (Display who is online)
 14:18:23 up  1:38,  1 user,  load average: 0.29, 0.27, 0.36
USER     TTY      FROM             LOGIN@   IDLE   JCPU   PCPU WHAT
itsachec :0       :0               12:39   ?xdm?  17:05   0.00s /usr/lib/gdm3/g

 whoami (who you are logged in)
itsacheckmate

--------------------------------------------

Name -       ls
Purpose-    lists all the files int the present working directory
ls commands
ls (displays directories and files visible under pwd)
Desktop    Downloads  Pictures  snap       Training
Documents  Music      Public    Templates  Videos

ls -R(it goes a step further to display files in sub-directories of the pwd)
.:
Desktop    Downloads  Pictures  snap       Training
Documents  Music      Public    Templates  Videos

./Desktop:

./Documents:

./Downloads:
slack-desktop-4.25.0-amd64.deb

./Music:

./Pictures:

./Public:

./snap:
snap-store

./snap/snap-store:
547  558  common  current

./snap/snap-store/547:

./snap/snap-store/558:

./snap/snap-store/common:

./Templates:

./Training:
 Git   linux   postgresql   README.md  'Untitled Diagram.drawio'

./Training/Git:
commands.txt

./Training/linux:
commands.txt

./Training/postgresql:
 AttendanceManagement.txt  'ER Diagram of AMS.drawio.png'
 commands.txt              'InBuilt Functions.txt'

./Videos:

 ls -a (displays hidden files in pwd)
.              .cache     .gitconfig  Pictures  .ssh
..             .config    .gnupg      .pki      .sudo_as_admin_successful
.bash_history  Desktop    .local      .profile  Templates
.bash_logout   Documents  .mozilla    Public    Training
.bashrc        Downloads  Music       snap      Videos

ls -al (it gives a detailed list ofthe displayed files and directories with extra information such as size etc)
total 96
drwxr-xr-x 19 itsacheckmate itsacheckmate 4096 Apr 19 13:11 .
drwxr-xr-x  3 root          root          4096 Apr 14 17:46 ..
-rw-------  1 itsacheckmate itsacheckmate  540 Apr 19 13:10 .bash_history
-rw-r--r--  1 itsacheckmate itsacheckmate  220 Apr 14 17:46 .bash_logout
-rw-r--r--  1 itsacheckmate itsacheckmate 3771 Apr 14 17:46 .bashrc
drwxrwxr-x 14 itsacheckmate itsacheckmate 4096 Apr 19  2022 .cache
drwx------ 13 itsacheckmate itsacheckmate 4096 Apr 19 13:37 .config
drwxr-xr-x  2 itsacheckmate itsacheckmate 4096 Apr 14 23:18 Desktop
drwxr-xr-x  2 itsacheckmate itsacheckmate 4096 Apr 14 23:18 Documents
drwxr-xr-x  2 itsacheckmate itsacheckmate 4096 Apr 19 12:44 Downloads
-rw-rw-r--  1 itsacheckmate itsacheckmate   63 Apr 19 13:00 .gitconfig
drwx------  3 itsacheckmate itsacheckmate 4096 Apr 19 13:57 .gnupg
drwxr-xr-x  3 itsacheckmate itsacheckmate 4096 Apr 14 23:18 .local
drwx------  5 itsacheckmate itsacheckmate 4096 Apr 19  2022 .mozilla
drwxr-xr-x  2 itsacheckmate itsacheckmate 4096 Apr 14 23:18 Music
drwxr-xr-x  2 itsacheckmate itsacheckmate 4096 Apr 14 23:18 Pictures
drwx------  3 itsacheckmate itsacheckmate 4096 Apr 19 12:46 .pki
-rw-r--r--  1 itsacheckmate itsacheckmate  807 Apr 14 17:46 .profile
drwxr-xr-x  2 itsacheckmate itsacheckmate 4096 Apr 14 23:18 Public
drwx------  3 itsacheckmate itsacheckmate 4096 Apr 19 12:27 snap
drwx------  2 itsacheckmate itsacheckmate 4096 Apr 19 13:08 .ssh
-rw-r--r--  1 itsacheckmate itsacheckmate    0 Apr 19 12:15 .sudo_as_admin_successful
drwxr-xr-x  2 itsacheckmate itsacheckmate 4096 Apr 14 23:18 Templates
drwxrwxr-x  6 itsacheckmate itsacheckmate 4096 Apr 19 13:21 Training
drwxr-xr-x  2 itsacheckmate itsacheckmate 4096 Apr 14 23:18 Videos


itsacheckmate@itscheckmate:~$ cd Downloads (to change directory)
itsacheckmate@itscheckmate:~/Downloads$ 

itsacheckmate@itscheckmate:~/Downloads$ cd (changes to the home directory)
itsacheckmate@itscheckmate:~$ 

itsacheckmate@itscheckmate:~$ cd / (takes you to the root directory of the linux os)
itsacheckmate@itscheckmate:/$ 

itsacheckmate@itscheckmate:~$ cat > temp.txt (create a file called temp)

itsacheckmate@itscheckmate:~$ cat temp.txt (display the contents of the file)
hello , wassup!

itsacheckmate@itscheckmate:~$ ls -l (Outputs the file and file permissions needed to access the target file)
total 48
drwxr-xr-x 2 itsacheckmate itsacheckmate 4096 Apr 14 23:18 Desktop
drwxr-xr-x 2 itsacheckmate itsacheckmate 4096 Apr 14 23:18 Documents
drwxr-xr-x 2 itsacheckmate itsacheckmate 4096 Apr 19 12:44 Downloads
drwxr-xr-x 2 itsacheckmate itsacheckmate 4096 Apr 14 23:18 Music
drwxr-xr-x 2 itsacheckmate itsacheckmate 4096 Apr 14 23:18 Pictures
drwxr-xr-x 2 itsacheckmate itsacheckmate 4096 Apr 14 23:18 Public
drwx------ 3 itsacheckmate itsacheckmate 4096 Apr 19 12:27 snap
-rw-rw-r-- 1 itsacheckmate itsacheckmate    1 Apr 19 15:06 temp
drwxr-xr-x 2 itsacheckmate itsacheckmate 4096 Apr 14 23:18 Templates
-rw-rw-r-- 1 itsacheckmate itsacheckmate   16 Apr 19 15:09 temp.txt
drwxrwxr-x 6 itsacheckmate itsacheckmate 4096 Apr 19 13:21 Training
drwxr-xr-x 2 itsacheckmate itsacheckmate 4096 Apr 14 23:18 Videos

itsacheckmate@itscheckmate:~$ sudo su - (to become the root user)

[sudo] password for itsacheckmate: 
root@itscheckmate:~# 

itsacheckmate@itscheckmate:~$ sudo su -
[sudo] password for itsacheckmate: 

root@itscheckmate:~# chown root / index.html
root@itscheckmate:~# ls
index.html  snap

root@itscheckmate:~# exit
logout
itsacheckmate@itscheckmate:~$ 

-------------------------------------------------------

Name -       Chmod
Purpose-      Change the access mode of the file i.e what user have the permission on the file 
wether they can edit it, or read or execute the file or the directory .

Reference   Class     Description
u          owner      file's owner

g          group      users who are members of
                      the file's group

o          others     users who are neither the
                      file's owner nor members of 
                      the file's group

a          all       All three of the above, same as ugo
Then there is operator which specify how the modes of files should be adjusted
Operator  Description
+         Adds the specified modes to the
          specified classes

-         Removes the specified modes from 
          the specified classes

=         The modes specified are to be made
          the exact modes for the specified 
          classes
and the the modes which indicate which permission is to be granted
r       Permission to read the file.
w       Permission to write (or delete) the file.
x       Permission to execute the file, or, in
        the case of a directory, search it.

the very first column represents the type of the file 
if its is a directory  'd' or if its a file the  '-'
then the folling 3set of letter represents the permission of the file owner
rwx =all three permission or rw- = only the read and write permission 

Then the following set off 3 letters are the group permission and other user permission
respectively 
if the directory has only x permission it means that there is premission to search the directory

root@itscheckmate:~# chmod 777 index.html (Everyone can access the file will have read,write and execute permissions)

chmod 755 - the owner will have read,write and execute permissions while other users will have only read and execute permissions -
root@itscheckmate:~# chmod 755 index.html 
root@itscheckmate:~# ls -l
total 4
-rwxr-xr-x 1 root root    0 Apr 19 15:30 index.html
drwxr-xr-x 3 root root 4096 Apr 14 23:18 snap

chmod 766 - sets permissions so that, owner can read, can write and can execute. (G)roup can read, can write and can't execute. (O)thers can read, can write and can't execute.
root@itscheckmate:~# chmod 766 index.html
root@itscheckmate:~# ls -l
total 4
-rwxrw-rw- 1 root root    0 Apr 19 15:30 index.html
drwxr-xr-x 3 root root 4096 Apr 14 23:18 snap

------------------------------------------------------------------

pwd - Prints working directory
It has 2 options 
		pwd -L: Prints the symbolic path. it is default command shwon by pwd 
					Also by the $pwd variable value is shown
		pwd -P: Prints the actual path.It is the path shown by /bin/pwd

itsacheckmate@itscheckmate:~$ pwd
/home/itsacheckmate
itsacheckmate@itscheckmate:~$ pwd -L
/home/itsacheckmate
itsacheckmate@itscheckmate:~$ pwd -P
/home/itsacheckmate

---------------------------------------------

Name -       shutdown
Purpose-    used to shutdown the system in a safe way.
Examples- syntax shutdown [OPTIONS] [TIME] [MESSAGE]
					sudo shutdown
					to shutdown the system at a specified time

It has 2 different formats
schedule a system shutdown at 7am:

tsacheckmate@itscheckmate:~$ sudo shutdown 7:00
[sudo] password for itsacheckmate: 
Shutdown scheduled for Wed 2022-04-20 07:00:00 IST, use 'shutdown -c' to cancel.

to broadcast a custom message-
itsacheckmate@itscheckmate:~$ sudo shutdown +10 "System upgrade"
Shutdown scheduled for Tue 2022-04-19 18:43:00 IST, use 'shutdown -c' to cancel.

this is to halt your system using -H option

shutdown -H
It means means stopping all CPUs and powering off also makes sure the main power is disconnected.
itsacheckmate@itscheckmate:~$ shutdown -h
Shutdown scheduled for Tue 2022-04-19 18:38:46 IST, use 'shutdown -c' to cancel.
itsacheckmate@itscheckmate:~$ means stopping all CPUs and powering off also makes sure the main power is disconnected.

sudo shutdown -c
 cannot specify a time argument, but can still broadcast a message 


shutdown -P
How to reboot using shutdown
For reboot, the option is -r.

itsacheckmate@itscheckmate:~$ sudo shutdown -c "cancelling the reboot of the system"

-------------------------------------------------------

Name-clear screen
It is used to clear the screen of the terminal.

--------------------------------------------------------

ps command - ps command is used to list the currently running processes and their PIDs along with some other information depends on different options.

itsacheckmate@itscheckmate:~$ ps
    PID TTY          TIME CMD
  19768 pts/1    00:00:00 bash
  33030 pts/1    00:00:00 ps



--------------------------------------------------

touch - The touch command is a standard command used in UNIX/Linux operating system which is used to create, change and modify timestamps of a file. It is used to create a file without any content.

itsacheckmate@itscheckmate:~$ touch temporary
itsacheckmate@itscheckmate:~$ ls
Desktop    Downloads  Pictures  snap  Templates  temp.txt  Videos
Documents  Music      Public    temp  temporary  Training

to create the multiple files
touch File1_name File2_name File3_name 

itsacheckmate@itscheckmate:~$ touch temp1 temp2
itsacheckmate@itscheckmate:~$ ls
Desktop    Downloads  Pictures  snap  temp1  Templates  temp.txt  Videos
Documents  Music      Public    temp  temp2  temporary  Training

touch -c : This command is used to check whether a file is created or not.
itsacheckmate@itscheckmate:~$ touch -c redhat
itsacheckmate@itscheckmate:~$ ls
Desktop    Downloads  Pictures  snap  temp1  Templates  temp.txt  Videos
Documents  Music      Public    temp  temp2  temporary  Training

touch -c-d : This is used to update access and modification time.
itsacheckmate@itscheckmate:~$ touch -c -d "17 April" temp1

touch -m : This is used to change the modification time only. It only updates last modification time.
itsacheckmate@itscheckmate:~$ touch -m temp1
itsacheckmate@itscheckmate:~$ ll
total 104
drwxr-xr-x 19 itsacheckmate itsacheckmate 4096 Apr 19 19:12 ./
drwxr-xr-x  3 root          root          4096 Apr 14 17:46 ../
-rw-------  1 itsacheckmate itsacheckmate  540 Apr 19 13:10 .bash_history
-rw-r--r--  1 itsacheckmate itsacheckmate  220 Apr 14 17:46 .bash_logout
-rw-r--r--  1 itsacheckmate itsacheckmate 3771 Apr 14 17:46 .bashrc
drwxrwxr-x 14 itsacheckmate itsacheckmate 4096 Apr 19  2022 .cache/
drwx------ 13 itsacheckmate itsacheckmate 4096 Apr 19 13:37 .config/
drwxr-xr-x  2 itsacheckmate itsacheckmate 4096 Apr 14 23:18 Desktop/
drwxr-xr-x  2 itsacheckmate itsacheckmate 4096 Apr 14 23:18 Documents/
drwxr-xr-x  2 itsacheckmate itsacheckmate 4096 Apr 19 12:44 Downloads/
-rw-rw-r--  1 itsacheckmate itsacheckmate   63 Apr 19 13:00 .gitconfig
drwx------  3 itsacheckmate itsacheckmate 4096 Apr 19 13:57 .gnupg/
drwxr-xr-x  3 itsacheckmate itsacheckmate 4096 Apr 14 23:18 .local/
drwx------  5 itsacheckmate itsacheckmate 4096 Apr 19  2022 .mozilla/
drwxr-xr-x  2 itsacheckmate itsacheckmate 4096 Apr 14 23:18 Music/
drwxr-xr-x  2 itsacheckmate itsacheckmate 4096 Apr 14 23:18 Pictures/
drwx------  3 itsacheckmate itsacheckmate 4096 Apr 19 12:46 .pki/
-rw-r--r--  1 itsacheckmate itsacheckmate  807 Apr 14 17:46 .profile
drwxr-xr-x  2 itsacheckmate itsacheckmate 4096 Apr 14 23:18 Public/
drwx------  3 itsacheckmate itsacheckmate 4096 Apr 19 12:27 snap/
drwx------  2 itsacheckmate itsacheckmate 4096 Apr 19 13:08 .ssh/
-rw-r--r--  1 itsacheckmate itsacheckmate    0 Apr 19 12:15 .sudo_as_admin_successful
-rw-rw-r--  1 itsacheckmate itsacheckmate    1 Apr 19 15:06 temp
-rw-rw-r--  1 itsacheckmate itsacheckmate    0 Apr 19 19:18 temp1
-rw-rw-r--  1 itsacheckmate itsacheckmate    0 Apr 19 19:12 temp2
drwxr-xr-x  2 itsacheckmate itsacheckmate 4096 Apr 14 23:18 Templates/
-rw-rw-r--  1 itsacheckmate itsacheckmate    0 Apr 19 19:11 temporary
-rw-rw-r--  1 itsacheckmate itsacheckmate   16 Apr 19 15:09 temp.txt
drwxrwxr-x  6 itsacheckmate itsacheckmate 4096 Apr 19 13:21 Training/
drwxr-xr-x  2 itsacheckmate itsacheckmate 4096 Apr 14 23:18 Videos/

touch -r : This command is used to use the timestamp of another file.
itsacheckmate@itscheckmate:~$ touch -r temp1 temp2
itsacheckmate@itscheckmate:~$ stat temp1
  File: temp1
  Size: 0         	Blocks: 0          IO Block: 4096   regular empty file
Device: 10305h/66309d	Inode: 1188051     Links: 1
Access: (0664/-rw-rw-r--)  Uid: ( 1000/itsacheckmate)   Gid: ( 1000/itsacheckmate)
Access: 2022-04-17 00:00:00.000000000 +0530
Modify: 2022-04-19 19:18:37.485721738 +0530
Change: 2022-04-19 19:18:37.485721738 +0530
 Birth: -
itsacheckmate@itscheckmate:~$ stat temp2
  File: temp2
  Size: 0         	Blocks: 0          IO Block: 4096   regular empty file
Device: 10305h/66309d	Inode: 1190609     Links: 1
Access: (0664/-rw-rw-r--)  Uid: ( 1000/itsacheckmate)   Gid: ( 1000/itsacheckmate)
Access: 2022-04-17 00:00:00.000000000 +0530
Modify: 2022-04-19 19:18:37.485721738 +0530
Change: 2022-04-19 19:19:29.041601731 +0530
 Birth: -

-------------------------------------------------------------


 
locate
find
grep
sudo
kill
ping
wget
top 
history

echo
zip,unzip


